NO ./textures/eagle.xpm
SO ./textures/mossy.xpm
WE ./textures/redbrick.xpm
EA ./textures/greystone.xpm

F 0,147,0
C 0,0,120

11111111     111111
1E000001     100001
1111000111111100101
1001100000000001001
1100000111111111011
10000001 1000000001
11111111 1111111111
