NO textures/texture.xpm
SO textures/texture.xpm
WE textures/texture.xpm
EA textures/texture.xpm
F 0,0,0
C 0,0,0

11111111
10100001
10100001
10000101
10000001
10N01101
10000001
11111111