NO textures/texture.xpm
SO textures/texture.xpm
WE textures/texture.xpm
EA textures/texture.xpm
F 0,0,0
C 0,0,0

1111111111     1111111
1001111111111111000001
1000000000000S00001101
1111111111111111011001
1111111111     1111111