NO textures/texture.xpm
SO textures/texture.xpm
F 0,0,0
C	0,0,0

111111111
100010001
100111001
111111111
