NO ./textures/bluestone.xpm
SO ./textures/colorstone.xpm
WE ./textures/greystone.xpm
EA ./textures/purplestone.xpm

F 47,79,79
C 176,224,230

        1111111111111111111111111
        1000000000110000000000001
        1011000000000000000000001
        1001000000000000N00000001
111111111011000000000000000000001
100000000011000001110111111111111
11110111111111011100000010001
11110111111111011101010010001
11000000110101011100000010001
10000000000000111100000010001
11111111111111111111111111111

