NO ./textures/eagle.xpm
SO ./textures/mossy.xpm
WE ./textures/redbrick.xpm
EA ./textures/greystone.xpm

F 0,147,0
C 0,0,120

1111111111111111111111111111111111111
1000000000000000000000000000000000001
10S0000000000000000000000000000000001
1000000000000000000000000000000000001
1000000000000000000000000000000000001
1000000000000000000000000000000000001
1000000000000000000000000000000000001
1000000000000000001110000000000000001
100000000000000001   1000000000000001
100000000000000001   1000000000000001
100000000000000001   1000000000000001
1000000000000000001110000000000000001
1000000000000000000000000000000000001
1000000000000000000000000000000000001
1000000000000000000000000000000000001
1000000000000000000000000000000000001
1000000000000000000000000000000000001
1000000000000000000000000000000000001
1000000000000000000000000000000000001
1111111111111111111111111111111111111
